00000000000000000000
00000000000000000000
00000000000000000000
00000000000000000000
00000000000000000000
02221113000000000000
02221113000000000000
02221113000000000000
02221113000000000000
02221100000000000000
00000000000000000000
00000000000000000000
00000000000000000000
00000000000000000000
00000000000000000000

Format: x-y-x1,y1-x2,y2-speed-moveto_pos1_first-move_vertically
IMPORTANT: x2 > x1 or y2 > y1
