00000000000000000000
00000000000000000000
00000000000000000000
00000000000000000000
00001111111101110000
02221110111101113330
02221110111111113330
02221110111111113330
02221110111111113330
00001110111111110000
00000000000000000000
00000000000000000000
00000000000000000000
00000000000000000000
00000000000000000000

Format: x-y-x1,y1-x2,y2-speed-moveto_pos1_first-move_vertically
IMPORTANT: x2 > x1 or y2 > y1