00000000000000000000
00000000000000000000
00000000000000000000
00000000000000000000
00001111111111110000
02221111111111113330
02221111111111113330
02221111111111113330
02221111111111113330
00001111111111110000
00000000000000000000
00000000000000000000
00000000000000000000
00000000000000000000
00000000000000000000

Format: x-y-x1,y1-x2,y2-speed-moveto_pos1_first-move_vertically
IMPORTANT: x2 > x1 or y2 > y1

12 - 4 - 12,4 - 12,8 - 1 - true - true
15 - 9 - 15,4 - 15,8 - 1 - false - true